####################
#                  #
#     ?       X    #
#   B  W  B       #
####################
