________________________
________________________
________________________
________?__C__B_________
__________________P_____
XXXXX_XXXXX_XXXXX_XXXXX_
X______________________X
X______G______________X
X__M__________________X
XXXXXXXXXXXXXXXXXXXXXXXX
